#####################
#S###################
#     #           # #
# ### # ####### #   #
# #   #       # #####
# ########### #     #
#     # #   # ##### #
#####   # # #     # #
#   # ##### # ##### #
# #   # #   # #   # #
# ##### # # # # # # #
#         # #   # # #
# # ##### # ##### # #
# # #     #       # #
###################E#
#####################