####################
#S##################
# #               ##
# # ### # ##########
#   #   #         ##
# ### ######### # ##
# #   #       # # ##
# ##### ##### ### ##
#   #       # #   ##
### # ##### # # # ##
#   # #   # # # # ##
### # # # # # # # ##
#   #   # # #   # ##
# ####### ##########
#       # #       ##
##### # # # ##### ##
#   # # #   #   # ##
# ### # ##### # # ##
#     #       # # E#
####################
