#####################
#S###################
#     #           #L#
# ### # ####### # DK#
# #LD #       # #####
# ########### #     #
#     #K#   # ##### #
#####   #4# # D6LL# #
#   # ##### # ##### #
# #   #8#   # #   # #
# #####9# # # # # # #
#         # #   # # #
#D#D##### # ##### #D#
#K#L#KL   #       #K#
###################E#
#####################
||
{'wall':'floor09','door':'door01','path':'floor04'}